SO    ./texture/mossy.xpm
WE ./texture/redbrick.xpm
EA      ./texture/wood.xpm
S   ./texture/ererv.xpm
C 256,255,204
F 51,51,51
R 1920 1080
NO                ./texture/colorstone.xpm


11111111111111
10000000000001
10000000000001111
100000000000000001
10000000000001111
10000000000001
10000000000001
10000000000001111
100000000000000001
10000000000001111
10000000000001
10000000000001
10000000000001
11111111111111