R     	1920 1080

SO ./tex/mossy.xpm
WE ./tex/redbrick.xpm
EA ./tex/wood.xpm
NO ./tex/greystone.xpm
S ./tex/pillar.xpm

C  0,110,200
F 150,150,130

11111111111111111111111111111111111111111111111111111111111111111
10000000000000000000000000000000000000000000000000000000000001
100000000000000000000000000000E00000000000000200000000000000011
10000000001111111100000000000000000000000000000000000000000011
1000000000100000010000000000000001111111111111111111111111111
1000000000100000010000000000000001
100000000011111101100000000000001
1000000000000000000000000000000001
1000000000000000000000000000000001
1111111111111111111111111111111111