R     	1920 1080

SO ./tex/mossy.xpm
WE ./tex/purplestone.xpm
EA ./tex/wood.xpm
NO ./tex/bluestone.xpm
S ./tex/pillar.xpm

C  50,110,20
F 100,15,130


11111111111111111111111111111111111111111111111111111111111111111
10000000000000000000000000000000000000000000000000000000000001
1000000000000000000000000000000S0000000000000000000000000000011
10000000001111111100000000000000000000000000000000000000000011
1000000000100000010000000000000001111111111111111111111111111
1000000000100000010000000000000001
1000000000111111011000000002000001
1000000000000000000000000000000001
1000000000000000000000000000000001
1111111111111111111111111111111111