R     	1920 1080

SO ./tex/mossy.xpm
WE ./tex/redbrick.xpm
EA ./tex/wood.xpm
NO ./tex/greystone.xpm
S ./tex/greenlight.xpm

C  0,110,200
F 150,150,130


11111111111111111111111111111111111111111111111111111111111111111
10000000000000000000000000000000000000000000000000000000000001
1000000000000000000000000000000S0000000000000000000000000000011
10000000001111111100000000000000000000000000000000000000000011
1000000000100000010000000000000001111111111111111111111111111
10000000001000000100000000000000000000000000000000000000000001
10000000001111110110000000020000000000000000000000000000000001
10000000000000000000000000000000000000000000000000000000000001
10000000000000000000000000000000000000000000000000000000000001
11111111110000000000000000111111111111111111111110000000000001
          11111111111111111111111                11111111111111111111111
		
